NO ./img/north_mock.xpm
WE ./img/west_mock.xpm
SO ./img/south_mock.xpm
EA ./img/east_mock.xpm

F 220,100,0
C 225,30,0

        11111111111111111111111111111111111111111
        10000000001100000000000000000000000000001
        10110000011100000000000000000000000000001
        10010000000000000000000000000000000000001
1111111110110000011100000000000000000000000000001
1000000000110000011101111100000000000000000001111
1111011111111101110000001000000000000000000001
1111011111111101110101001000000000000000000001
1100000011010101110000001000000000000000000001
1000000000000000110000001000000000000000000001
1000000000000000110101001000000000000000000001
1000000000000000110101001000000000000000000001
1000000000000000110101001000000000000000000001
1000000000000000110101001000000000000000000001
1000000000000000110101001000000000000000000001
1000000000000000110101001000000000000000000001
1000000000000000110101001000000000000000000001
1000000000000000110101001000000000000000000001
1000000000000000110101001000000000000000000001
1000000000000000110101001000000000000000000001
1111111111111111111111111100000000000000000001
1000000000000000110101001000000000000000000001
1000000000000000110101001000000000000000000001
1000000000000000110101001000000000000000000001
1000000000000000110101001000000000000000000001
1000000000000000110101001000000000000000000001
1000000000000000110101001000000000000000000001
1000000000000000110101001000000000000000000001
1000000000000000110101001000000N00000000000001
1000000000000000110101001000000000000000000001
1000000000000000110101001000000000000000000001
1000000000000000110101001000000000000000000001
1000000000000000110101001000000000000000000001
1000000000000000110101001000000000000000000001
1000000000000000110101001000000000000000000001
1000000000000000110101001000000000000000000001
1000000000000000110101001000000000000000000001
1000000000000000110101001000000000000000000001
1000000000000000110101001000000000000000000001
1000000000000000110101001000000000000000000001
1000000000000000110101001000000000000000000001
1000000000000000110101001000000000000000000001
1000000000000000110101001000000000000000000001
1000000000000000110101001000000000000000000001
1000000000000001110101001000000000000000000001
1111111111111111111111111100000000000000000001
1100000111010101111101111000000000000000000001
11110111 1110101110111101000000000000000000001
11111111 1111111111111111100000000000000000001
11111111 1111111111111111111111111111111111111
