NO ./img/north_mock.xpm
WE ./img/west_mock.xpm
SO ./img/south_mock.xpm
EA ./img/east_mock.xpm


F 220,100,0
C 225,30,0
111111111
100000001
101111101
101000101
1010N0101
101000101
101111101
100000001
111111111