NO ./img/north_mock.xpm
WE ./img/west_mock.xpm
SO ./img/south_mock.xpm
EA ./img/east_mock.xpm

F 220,100,0
C 225,30,0

        11111111111111111111111111111111111111111111111111111111
        10000000001100000000000000000000000000000000000000000001
        10110000011100000000000000000000000000000000000000000001
        10010000000000000000000000000000000000000000000000000001
1111111110110000011100000000000000000000000000000000000000000001
1000000000110000011101111100000000000000000000000000000001011111
111101111111110111000000100000000000000000000000000000000001
1111011111 1110111010100100000000000000000000000000000000001
110000001101010111000000100000000000000000000000000000000001
100000000000000011000000100000000000000000000000000000000001
100000000000000011010100100000000000000000000000000000000001
100000000000000011010100100000000000000000000000000000000001
100000000000000011010100100000000000000000000000000000000001
100000000000000011010100100000000000000000000000000000000001
100000000000000011010100100000000000000000000000000000000001
100000000000000011010100100000000000000000000000000000000001
100000000000000011010100100000000000000000000000000000000001
100000000000000011010100100000000000000000000000000000000001
100000000000000011010100100000000000000000000000000000000001
100000000000000011010100100000000000000000000000000000000001
11111111 1111111 11111111100000000000000000000N0000000000101
100000000000000011010100100000000000000000000000000000000001
100000000000000011010100100000000000000000000000000000000001
100000000000000011010100100000000000000000000000000000000001
100000000000000011010100100000000000000000000000000000000001
100000000000000011010100100000000000000000000000000000000001
11111111 1111111 1111111110000000000000000000000000000000101
11000001110101011111011110000000000000000000000000000000000111
11110111 1110101 1011110100000000000000000000000000000000001
11111111 1111111 1111111110000000000000000000000000000000101
11111111 1111111 1111111111111111111111111111111111111111111