NO ./img/north_mock.xpm
SO ./south_mock.xpm
WE ./img/west_mock.xpm
EA ./img/east_mock.xpm

F 220,100,
C 225,0,0

11111111111
10000000001
10000N00001
10000000001
11111111111