NO ./img/north_mock.xpm
WE ./img/west_mock.xpm
SO ./img/south_mock.xpm
EA ./img/east_mock.xpm

F 220,100,0
C 225,30,0

11111111011
10000000001
10000000001
10000000001
11111111111